Австралия: Отдых в Австралии 
Айерс-Рок, Большой Барьерный риф, Дарвин, Золотое Побережье, Квинсленд, Кэрнс, Мельбурн, Сидней
Австрия: Отдых в Австрии 
Аннаберг, Ахенкирх, Бад Гастайн, Бад Гаштайн, Бад Хофгастайн, Баден, Бад-Татцмансдорф, Берванг, Вена, Вольфгангзее, Гальтур, Гоинг, Дюрнштайн, Заальбах, Зальцбург, Зальцкаммергут, Зеефельд, Зелль, Зельден, Земмеринг, Иглс, Имст, Инсбрук, Ишгль, Капрун, Каринтия, Кирхберг, Кицбюэль, Клопайнер-Зее, Кримль, Ландек, Ленгенфельд, Лех, Линц, Майерхофен, Мельк, Наудерс, Нойштифт-им-Штубайталь, Обергургль, Обертауэрн, Отцталь, Пертчах, Пицталь, Санкт-Антон, Серфаус, Тироль, Фельден, Финкенберг, Фисс, Хинтерглем, Целль-ам-Зее, Цель-ам-Циллер, Цюрс, Шладминг
Азербайджан: Отдых в Азербайджане 
Гянджа, Нафталан
Албания: Отдых в Албании 
Влёра
Алжир: Отдых в Алжире 
Алжир, Сетифе
Ангола: Отдых в Анголе 
Андорра: Отдых в Андорре 
La Cortinada, ORDINO, Андорра Ла Велла, Аринсаль, Канильо, Ла Массана, Пас де ла Каса - Грау Рож, Солдеу-Эль Тартер, Энкамп, Эскальдес
Антигуа: Отдых в Антигуа 
Антигуа
Аргентина: Отдых в Аргентине 
Буэнос-Айрес, Игуасу, Калафате, Мендоса, Пуэрто-Игуасу, Пуэрто-Мадрин, Сальта, Сан-Рафаэль, Ушуая, Эль-Калафате
Армения: Отдых в Армении 
Ереван
Аруба: Отдых Арубе 
Ораньестад
Афганистан: Отдых в Афганистане 
Багамские острова: Отдых на Багамских островах 
Нассау, о. Большая Багама, о. Большой Абако, о. Парадиз, о. Эльютера, Эксума
Бангладеш: Отдых в Бангладеше 
Барбадос: Отдых на Барбадосе 
Бриджтаун, мыс Крист Черч
Беларусь: Отдых в Беларуси 
Брест, Витебск, Гомель, Гродно, Минск, Могилев
Белиз: Отдых в Белизе 
Атолл Тернеф, Сан-Педро
Бельгия: Отдых в Бельгии 
Антверпен, Брюгге, Брюссель, Ватерлоо, Намюр, Остенд
Бенин: Отдых в Бенине 
Болгария: Отдых в Болгарии 
Албена, Ахелой, Балчик, Банско, Баня (Карлово), Боровец, Бургас, Бяла, Варна, Велико-Тырново, Велинград, Габрово, Долна Баня, Дюны, Елените, Золотые пески, Камчия, Китен, КК Чайка, Кранево, Кюстендил, Несебр, Обзор, Павел баня, Пампорово, Поморие, Приморско, Равда, Ривьера, Русалка, Сандански, Сарафово, Св. Константин и Елена, Св.Влас, Созополь, Солнечный берег, Солнечный день, София, Царево, Черноморец
Боливия: Отдых в Боливии 
Босния и Герцеговина: Отдых в Боснии и Герцеговине 
Ботсвана: Отдых в Ботсване 
Парк Чобе
Бразилия: Отдых в Бразилии 
Амазония, Ангра-дус-Рейс, Бузиос, Игуассу, Копакабана, Коста-ду-Сауипе, Манаус, Пантанал, Рио-де-Жанейро, Сальвадор, Сальвадор (пляжи Сальвадора), Сан-Пауло, Фос-ду-Игуасу
Бруней: Отдых в Брунее 
Буркина-Фасо: Отдых в Буркина-Фасо 
Бурунди: Отдых в Бурунди 
Бутан: Отдых в Бутане 
Вануату: Отдых Вануату 
Ватикан: Отдых в Ватикане 
Великобритания: Отдых в Великобритании 
Англия, Брайтон, Виндзор, Гастингс, Глазго, Гринвич, Дорсет, Истборн, Йорк, Кембридж, Ковентри, Ланкашир, Ливерпуль, Лондон, Манчестер, Ноттингем, Оксфорд, Сассекс, Стаффордшир, Стрэтфорд-он-Эйвон, Уэльс, Эдинбург
Венгрия: Отдых в Венгрии 
Балатонфюред, Будапешт, Бюкфюрдо, Веспрем, Вышеград, Дебрецен, Дьер, Залакарош, Лиллафюред, Мишкольц, Ниредьхаза, озеро Балатон, Парадфюрдё, Секешфехервар, Сентендре, Тапольце, Токай, Хайдусобосло, Харкане, Хевиз, Шарвар, Эгер, Эгерсалок, Эстергом
Венесуэла: Отдых в Венесуэле 
Каракас, Маргарита
Виргинские Британские острова: Отдых на Виргинских Британских островах 
Восточный Тимор: Отдых в Восточном Тиморе 
Вьетнам: Отдых во Вьетнаме 
Вунгтау, Далат, Дананг, Кантхо, Лонгхай, Муйнэ, Ниньтхуан, Нячанг, Сапа, Туан Чау, Фантхьет, Фу Куок, Халонг, Ханой, Хой Ан, Хошимин, Хуэ, Чаудок
Габон: Отдых в Габоне 
Гаити: Отдых на Гаити 
Гайана: Отдых Гайана 
Гамбия: Отдых в Гамбии 
Гана: Отдых Гана 
Гватемала: Отдых в Гватемале 
Антигуа, оз. Атитлан, Тикаль
Гвинея: Отдых Гвинея 
Гвинея-Бисау: Отдых в Гвинее-Бисау 
Германия: Отдых в Германии 
Баден-Баден, Баден-Вюртемберг, Бамберг, Берлин, Бремен, Вестфалия, Виттен, Виттенберг, Гамбург, Ганновер, Гармиш-Партенкирхен, Грейфсвальд, Детмольд, Дрезден, Дюссельдорф, Кель, Кельн, Кёнигштайн, Киль, Кобленц, Лейпциг, Магдебург, Майнц, Майсен, Мангейм, Мюнхен, Норд-Рейн, Нюрнберг, Одерберг, Пассау, Пенемюнде, Потсдам, Рюдесхайм, Тропические острова, Фогельсберг, Фрайбург, Франкфурт на Майне, Хиддензе, Шпейер, Штральзунд, Штуттгардт, Эберсвальде
Гондурас: Отдых в Гондурасе 
Ла-Москития
Греция: Отдых в Греции 
Агиа Пелагия (о. Крит), Агиос Иоаннис, Агиос Николаос (о. Крит), Аделе (о. Крит), Александруполис, Альмирида (о. Крит), Амудара (о. Крит), Арголида, Аттика, Афины, Афон (Халкидики), Бали (о. Крит), Георгиуполис (о. Крит), Глифада (о. Корфу), Дельфы, Иксия, Ираклион (о. Крит), Итея, Кавала, Каламбака, Кассандра (Халкидики), Касторья, Катаколон, Керкира, Коккини Хани (о. Крит), Колимбари (о. Крит), Лептокария, Лутраки, Македония, Малья (о. Крит), Месолонгион, Метеора, Милатос (о. Крит), Миссирия (о. Крит), Неа Калликратия (Халкидики), о. Закинф, о. Икария, о. Калимнос, о. Кея, о. Кифира, о. Корфу, о. Кос, о. Крит, о. Лемнос, о. Лерос, о. Лесбос, о. Миконос, о. Паксос, о. Парос, о. Патмос, о. Родос, о. Самос, о. Санторини, о. Сирос, о. Тасос, о. Хиос, о. Эвия, о.Аморгос, о.Антипарос, Парга, Парнас, Пелопоннес, Пиерия, Пиерия (вкл. Паралия-Катерини), Пирей, Платаньяс (о. Крит), Полигирос, Ретимно (о. Крит), Салоники, Ситония (Халкидики), Сталис (о. Крит), Херсониссос (о. Крит), Эдиспос, Ялиссос
Грузия: Отдых в Грузии 
Аджария, Анаклиа, Ахалцихе, Бакуриани, Батуми, Боржоми, Вардзиа, Гонио, Гори, Григолети, Гудаури, Казбеги, Кахети, Квариати, Кобулети, Кутаиси, Мцхета, Саирме, Сванетия, Сигнахи (Сигнаги), Тбилиси, Телави, Уреки, Цихисдзири, Чакви
Дания: Отдых в Дании 
Вестманна (Фарерские острова), Копенгаген, о. Вагар (Фарерские острова), о. Микинес (Фарерские острова), Ольборг, Роскилле, Торсхавн (Фарерские острова)
Джибути: Отдых в Джибути 
Доминикана: Отдых в Доминикане 
Бока Чика, Кабарете, Кап Кана, Ла Романа, Пунта Кана, Пуэрто Плата, Самана, Санто-Доминго, Сосуа, Хуан Долио
Египет: Отдых в Египте 
Айн Эль Сохна, Александрия, Дахаб, Заафарана, Каир, Макади Бей, Марса-Алам, Наама Бей, Нувейба, о. Фараона, Сафага, Сома Бей, Таба, Хургада, Шарм-эль-Шейх, Эль Гуна, Эль-Кусейр
Замбия: Отдых в Замбии 
Водопад Виктория, Ливингстон, Лусака
Западная Сахара: Отдых в Западной Сахаре 
Зимбабве: Отдых в Зимбабве 
Водопады Виктория
Израиль: Отдых в Израиле 
Cафед, Арад, Ашдод, Вифлеем, Иерусалим, Капернаум, Мертвое море, Назарет, Нетания, Рамат Ган, Рош-Пина, Тверия, Тель-Авив, Хайфа, Херцилия, Эйлат, Эйн-Бокек, Яффо
Индия: Отдых в Индии 
Агра, Аруначал Прадеш, Бхаратпур, Варанаси, Вишакхапатнам, Гвалиор, Гоа, Гуджарат, Дарджилинг, Дармсала, Дели, Дехрадун, Джайпур, Джамму, Джанси, Индаур, Каджурахо, Калькутта, Карнатака, Кашмир, Керала, Ковалам, Кучаман, Кхаджурахо, Манали, Мандава, Матхура, Махараштра, Морари, Нави Мумбаи, Наланда, Орисса, Орчха, Патна, Пенджаб, Пувар, Пушкар, Рантамбор, Сикким, Тамилнад, Удайпур, Утакаманд, Уттар Прадеш, Уттаракханд, Фатехпур, Хайдарабад, Химачал, Чандигар, Ченнай (Мадрас), Човара, Шимла
Индонезия: Отдых в Индонезии 
Джакарта, Джимбаран, Карангасем, Кута, Легиан, Ломбок, Нуса Дуа, о.Бинтан, о-ва.Гили, остров Бали, Санур, Семиньяк, Танжунг Беноа
Иордания: Отдых в Иордании 
Акаба, Амман, Вифания, Иорданская долина, Красное море, Мадаба, Мертвое море, Небо, Петра, пустыня Вади Рам
Ирак: Отдых в Ираке 
Иран: Отдых в Иране 
Дизин, Тегеран
Ирландия: Отдых в Ирландии 
Белфаст, Голуэй, Донегол, Дублин, Корк, Лондондерри, Слайго, Уотерфорд, Уэксфорд
Исландия: Отдых в Исландии 
Акюрейри, Боргарнес, Рейкхольт, Рейкьявик, Судурнэс, Тоурсмёрк, Хусавик, Эйстюрланд
Испания: Отдых в Испании 
Аликанте, Алькудиа, Ареналь, Аркос-де-ла-Фронтера, Барселона, Беналмадена, Бенидорм, Бильбао, Бланес, Валенсия, Гран Канария, Гранада, Жирона, Ибица, Ильетас, Кала Виньяс, Кала Майор, Кала Пи, Калелья, Камбрильс, Камп Де Мар, Кан Пастилья, Кан Пикафорт, Канарские острова, Кастилия, Кордова, Коста Бланка, Коста Брава, Коста дель Маресме, Коста Дель Соль, Коста Ден Бланес, Коста Дорада, Коста-Баска, Коста-де-ла-Лус, Ла Пинеда, Ла-Корунья, Лансароте, Лорет-де-Мар, Ль’Аметлья-де-Мар, Магальюф, Мадрид, Майами плайя (Miami Platja), Малграт Де Мар, Марбелья (Коста-дель-Соль), Маспаломас, о. Майорка, Памплона, Пинеда де Мар, Плайа Де Муро, Плайя де Сан Августин, Плайя Дель Инглес, Плая Де Пальма, Порт Авентура, Порт де Польенса, Порталс Ноус, Порто Кристо, Порто Петро, Салоу, Сан-Сальвадор, Сан-Себастьян, Санта Понса, Санта Сусанна, Санта Эулалия дель Рио, Санта-Пола, Сарагоса, Севилья, Сиерра Невада, Ситжес, Сьера-Невада, Таррагона, Тенерифе, Толедо, Торремолинос, Тосса Де Мар, Фигейрас, Фуертевентура, Эль-Перельо, Эстепона
Италия: Отдых в Италии 
Corvara, Forte Dei Marmi, Абано Терме, Алассио, Аллеге, Альберобелло, Альта-Вальтеллина, Амальфи, Анкона, Апулия, Арабба, Ареццо, Бари, Бергамо, Бордигера, Бормио, Валле-д'Аоста, Валь Гардена, Валь-ди-Соль, Валь-ди-Фаса, Валь-ди-Фьемме, Венето: Бибионе, Венеция, Верона, Версилия, Вилласимиус, Гаета, Генуя, Гроссето, Джульянова, Диано Марина, Империя, Казерта, Катания, Кортина-д'Ампеццо, Курмайор, Ладисполи, Ливиньо, Ливорно, Лигурия, Лидо ди Езоло, Линьяно, Липарские острова, Лоано, Мадонна-ди-Кампильо, Марина ди Казаль-Велино, Марина-ди-Камерота, Мессина, Милан, Монтекатини-Терме, Неаполитанская ривьера, Неаполь, Неттуно, Ноли, о. Бурано, о. Искья, о. Мурано, о. Сицилия, о. Торчелло, о.Эльба, оз. Гарда, Ортизей, Падуя, Парма, Пезаро, Перуджа, Пиза, Позитано, Помпеи, Понца, Порто Черво, Пьетра Лигуре, Равенна, Рапалло, Рим, Римини, Сабаудия, Сан Бартоломео Аль Маре, Сан Ремо, Сан Феличе Чирчео, Сан-Марино, Санта Маргеритa Лигуре, Санто Стефано аль Маре, Сардиния, Сельва Гардена, Сестриер, Сиена, Сперлонга, Споторно, Терни, Террачина, Тиволи, Тревизо, Трентино — Альто-Адидже, Триест, Удине, Феррара, Финале Лигуре, Флоренция, Фьюджи, Челле Лигуре, Червиния, Чивитавеккья, Эмилия-Романья
Йемен: Отдых в Йемене 
Кабо-Верде: Отдых в Кабо-Верде 
Зеленый Мыс, о. Сал, Прая, Санта Мария
Казахстан: Отдых в Казахстане 
Караганда, Озеро Алаколь
Камбоджа: Отдых в Камбодже 
Кеп, Кох Кер, Пномпень, Прэахвихеа, Сиам-Рип, Сиануквиль, Сиемреап
Камерун: Отдых в Камеруне 
Канада: Отдых в Канаде 
Банфф, Ванкувер, Вистлер, Оттава, Торонто
Катар: Отдых в Катаре 
Кения: Отдых в Кении 
Амбосели, Масаи Мара, Момбаса, Найроби, Национальный Парк Ол Педжета, озеро Найваша, озеро Накуру, Самбуру, Тсаво
Кипр: Отдых на Кипре 
Айя-Напа, Какопетрия, Кирения, Ларнака, Лимассол, Никосия, Пафос, Писсоури, Платрес, Полис, Протарас, Чаталкой
Китай: Отдых в Китае 
Гонконг, Гуанчжоу, Гуйлинь, Дадунхай, Далянь, Инкоу, Куньмин, Лицзянь, Лоян, Лхаса, Макао, Наньцзин, Пекин, Санья, о. Хайнань, Сиань, Сучжоу, Сямэнь, Тингри, Удан Шань, Хайнань, Ханчжоу, Хэбэй, Цзинань, Цзинхун, Ченду, Чендэ, Чжанцзяцзе, Чжуцзяцзяо, Чжэнчжоу, Чунцин, Шанхай, Шаолинь, Шигацзе, Шэньчжень, Яншо
Колумбия: Отдых в Колумбии 
Богота, Картахена, Летисия, Перейра
Конго: Отдых в Конго 
Косово: Отдых в Косово 
Коста-Рика: Отдых в Коста-Рика 
Пуэрто-Хименес, Тортугеро
Кот-д’Ивуар: Отдых в Кот-д’Ивуаре 
Куба: Отдых на Кубе 
Варадеро, Вилья-Клара, Гавана, Гуантанамо, о. Кайо-Гильермо, о. Кайо-Коко, о. Кайо-Ларго, о. Кайо-Энсеначос, о. Санта-Мария, Ольгин, Пинар-дель-Рио, Плайя Гуардалавака, Плайя Эсмеральда, Сантьяго-Де-Куба, Сьенфуэгос, Тринидад, Эсмеральда-Ольгин
Кувейт: Отдых в Кувейте 
Кыргызстан: Отдых в Кыргызстане 
Лаос: Отдых в Лаосе 
Пакбенг, Сианг Хоанг
Латвия: Отдых в Латвии 
Адажи, Рига, Рундале, Сигулда, Цесис, Юрмала
Лесото: Отдых в Лесото 
Либерия: Отдых в Либерии 
Ливан: Отдых в Ливане 
Баальбек, Бейрут, Триполи, Фарайя
Ливия: Отдых в Ливии 
Литва: Отдых в Литве 
Алитус, Вильнюс, Друскининкай, Каунас, Клайпеда, Мариямполе, Паланга, Таураге, Тракай, Шилуте, Шяуляй (Шауляй)
Люксембург: Отдых в Люксембурге 
Вианден, Люксембург
Маврикий: Отдых на Маврикие 
о. Маврикий, Порт-Луи (о.Маврикий)
Мавритания: Отдых в Мавритании 
Мадагаскар: Отдых на Мадагаскаре 
Амбалавао, Андасибе, Махаджанга, Нози Би, Сент Мери, Тулеар
Македония: Отдых в Македонии 
Маврово, Охрид, Скопье
Малави: Отдых в Малави 
Малайзия: Отдых в Малайзии 
Кота-Кинабалу (Сабах), Куала-Лумпур, Лумут, о. Борнео, о. Ланкави, о. Реданг, о. Тиоман, остров Пинанг, Пангкор Лаут, Саравак (о. Борнео), Теренггану
Мали: Отдых в Мали 
Мальдивы: Отдых на Мальдивах 
Адду Атолл, Ари Атолл, Атолл Тхаа, Баа Атолл, Вааву Атолл, Донакули, Лааму Атолл, Лавиани Атолл, Мале, Мальдивcкие острова, Мииму Атолл, Налагурайду, Ноону Атолл, Раа & Баа Атоллы, Расду Атолл, Северный Мале Атолл, Фаафи & Даалу Атоллы, Хаа Алифу Атолл, Хувахенду, Южный Мале Атолл
Мальта: Отдых на Мальте 
Аура, Буджибба, Валлетта, Гзира, Голден Бей, Марсаскала, Марфа, Мдина, Меллиха, о. Гозо, о. Комино, Сент-Джулианс, Слима, Ст. Паулс Бэй, Чиркева
Марокко: Отдых в Марокко 
Агадир, Касабланка, Маракеш, Рабат, Сафи, Танжер, Ущелье Дадес, Фес, Шефшауэн, Эрфуд, Эссуейра
Мексика: Отдых в Мексике 
Акапулько, Веракрус, Гвадалахара, Гуанахуато, Кабо-Сан-Лукас, Кампече, Канкун, Косумель, Кспу-Ха, Куэрнавака, Мехико, Монтеррей, Морелия, Наярит, Оаксака, Оахака, Паленке, Плайа дель Кармен, Ривьера Майя, Сан Кристобаль де Лас Касас, Сихуатанехо, Таско, Техуантепек, Тихуана, Четумаль, Чьяпас, Юкатан
Мозамбик: Отдых в Мозамбик 
Мапуту
Молдова: Отдых в Молдове 
Монако: Отдых в Монако 
Монако
Монголия: Отдых Монголия 
Мьянма: Отдых в Мьянме 
Ава, Амарапура, Баган, Мандалай, Мингун, Мьитчина, Нгапали, Нгвэ Саунг, оз. Инле, Пиндайя, Пьей, Хехо, Чайтхийо, Чаунта, Янгон
Намибия: Отдых в Намибии 
Непал: Отдых в Непале 
Дхуликхел, Катманду, Лумбини, Нагаркот, Покхара, Читван
Нигер: Отдых в Нигере 
Нигерия: Отдых в Нигерии 
Нидерландские Антильские Острова: Отдых на Нидерландские Антильские Острова 
О. Кюрасао
Нидерланды: Отдых в Нидерландах 
Амстердам, Волендам, Гаага, Дельфт, Зандвоорт, Маастрихт, Неймеген, о. Аруба, Роттердам, Северная Голландия, Утрехт, Флеволанд, Эйндховен, Эфтелинг, Южная Голландия
Никарагуа: Отдых в Никарагуа 
Гранада, Манагуа
Новая Зеландия: Отдых в Новой Зеландии 
Веллингтон, Данидин, Залив Островов, Залив Пленти, Квинстаун, Крайстчерч, Ледник Франца-Иосифа, Нортленд, о. Стьюарт, Окленд, Пиктон, Роторуа
Новая Каледония: Отдых в Новой Каледонии 
Норвегия: Отдых в Норвегии 
Альта, Берген, Будё, Гейло, Гейрангер, Драммен, Киркенес, Кристиансанн, Ларвик, Лиллехаммер, Лонгйир, Молде, Нарвик, Нурефьель, Олесунн, Оппланн, Осло, Рана, Ругаланн, Сарпсборг, Ставангер, Тромсе, Тронхейм, Флурё, Фредрикстад, Хамар, Харстад, Хордаланд, Шиен, Эйдфьорд
ОАЭ: Отдых в ОАЭ 
Абу-Даби, Аджман, Аль-Айн, Дейра, Джебель-Али, Джумейра, Дубай, Корфакан, Рас-эль-Хайма, Умм-эль-Кайвайн, Фуджейра, Шарджа
Оман: Отдых в Омане 
Аль-Савади, Батина, Маскат, Низва, Салала, Сохар, Сур, Эль-Хасаб
Пакистан: Отдых в Пакистане 
Палау: Отдых в Палау 
Палестинская автономия: Отдых в Палестинской автономии 
Панама: Отдых Панама 
Давид, Кокле, Сан-Блас
Папуа и Новая Гвинея: Отдых Папуа и Новой Гвинее 
Парагвай: Отдых Парагвай 
Перу: Отдых в Перу 
Арекипа, Ика, Каньон Колка, Кахамарка, Куско, Лима, Мачу-Пикчу, Наска, Паракас, Пуно, Пуэрто-Малдонадо, Священная долина Инков, Тумбес
Польша: Отдых в Польше 
Lodz, Беловежа, Бялка Татранская, Варшава, Величка, Висла, Вроцлав, Гданьск, Гижицко, Закопане, Карпач, Катовице, Краков, Красичин, Крыница, Ланцут, Леба, Леско, Люблин, Мурзасихле, Ойцов, Пшемысль, Сверадув Здруй, Спытковице, Устрики Дольные, Шклярска Поремба, Щецин, Щирк
Португалия: Отдых в Португалии 
Алгарве, Алмоурол, Ангра-ду-Эроишму, Баталья, Виана-ду-Каштелу, Гимараеш, Каркавелос, Кашкайш, Каштело де Виде, Лиссабон, Мадейра, Монсараш, Обидуш, Пику, Порту, Сан-Жоржи, Сан-Мигел, Сесимбра, Синтра, Терсейра, Томар, Фатима, Фаял, Фуншал, Эшторил
Пуэрто-Рико: Отдых в Пуэрто-Рико 
Россия: Отдых в России 
Великий Новгород, Владимир, Геленджик, Гороховец, Домбай, Ессентуки, Железноводск, Изборск, Кабардино-Балкария, Казань, Камчатка, Карелия, Кижи, Кисловодск, Кострома, Красная Поляна, Москва, Муром, Петропавловск-Камчатский, Плес, Приэльбрусье, Пятигорск, Ростов, Ростов-на-Дону, Санкт-Петербург, Соловки, Сочи, Суздаль, Эльбрус, Ярославль
Руанда: Отдых в Руанде 
Румыния: Отдых в Румынии 
Азуга, Брашов, Бухарест, Буштени, Ватра Дорней, Венус, Клуж-Напока, Мамая, Нептун, Олимп, Пояна Брашов, Предял, Прежмер, Сатурн, Сигишоара, Синая, Тимишоара, Трансильвания, Эфорие Норд, Юпитер, Яссы
Сальвадор: Отдых в Сальвадоре 
Самоа: Отдых в Самоа 
Сан-Марино: Отдых в Сан-Марино 
Сан-Марино
Саудовская Аравия: Отдых Саудовская Аравия 
Джидда, Медина, Мекка, Эр-Рияд
Свазиленд: Отдых в Свазиленде 
Северная Корея: Отдых в Северной Корее 
Северные Марианские острова: Отдых на Северных Марианских островах 
Сейшельские острова: Отдых на Сейшельских островах 
Денис, Дерош, Кузин, Ла Диг, Маэ, о. Берд, о. Праслин, о. Северный, о. Силуэт, о.Серф, Сент-Ан, Фелисите, Фрегат
Сенегал: Отдых в Сенегале 
Сент-Винсент и Гренадины: Отдых в Сент-Винсент и Гренадины 
Сент-Люсия: Отдых в Сент-Люсии 
Сербия: Отдых в Сербии 
Kopaonik, Белград, Нови Сад
Сингапур: Отдых в Сингапуре 
Сингапур
Сирия: Отдых в Сирии 
Словакия: Отдых в Словакии 
Бардеевские Купеле, Бардейов, Бешенева, Бойнице, Братислава, Высокие Татры, Вышне Ружбахи, Герлахов, Демановская долина, Дольни-Кубин, Дубовица, Дудинце, Ждяр, Земплинска Ширава, Кошице, Кромпахи, Левоча, Липтовски Микулаш, Липтовски Ян, Лучки, Любовнянские Купеле, Медзилаборце, Низкие Татры, Новый Смоковец, Подбанске, Попрад, Пьештяны, Раецка Лесна, Раецке Теплице, Ружомберок, Слиач, Словацкий рай, Смоковцы, Солнечные Озера, Солнечные Озера (Senec), Спишска-Нова-Вес, Стара Лесна, Стара Любовнa, Старый Смоковец, Татраландия, Татранска Ломница, Татранска Штраба, Татранске Зрубы, Тренчианске Теплице, Турчианске Теплице, Штос, Штребске Плесо, Ясна
Словения: Отдых в Словении 
Анкаран, Блед, Бовец, Бохинь, Доленске Топлице, Изола, Копер, Краньска Гора, Крвавец, Любляна, Марибор, Моравске Топлице, озеро Бохинь, Оточец, Пиран, Порторож, Птуй, Рогашка Слатина, Талассо Струньян, Терме Зрече, Терме Олимия, Терме Раденци, Терме Чатеж, Термы Лашко, Шмарьешке Топлице
Соломоновы Острова: Отдых на Соломоновых Островах 
Сомали: Отдых в Сомали 
Судан: Отдых в Судане 
Суринам: Отдых в Суринам 
США: Отдых в США 
Аризона, Биг Айленд (Гавайские острова), Большой Каньон, Бостон, Брайс Каньон, Вашингтон, Вирджиния, Гавайские острова, Гонолулу (штат Гавайи), Джексон, Долина Напа, Зайон-каньон, Йосемитский заповедник, Калифорния, Кауаи (Гавайские острова), Лас-Вегас, Лос-Анджелес, Майами, Мауи (штат Гавайи), Мексиканский залив, Национальный парк Йеллоустон, Невада, Нью-Йорк, оз. Отсего, Орегон, Орландо, Пенсильвания, Род-Айленд, Сан-Диего, Сан-Франциско, Сент-Огастин, Солт-Лейк-Сити, Флорида, Юта
Сьерра-Лионе: Отдых в Сьерра-Лионе 
Таджикистан: Отдых в Таджикистане 
Таиланд (Тайланд): Отдых в Таиланде (Тайланде) 
Аюттая, Бангкок, Канчанабури, Као Лак, Ко Крадан, Ко Чанг, Ко Яо Яй, Краби, Кханом, Лампанг, Мае Сот, Маехонгсон, Мэй Хонг Сон, Накхонратчасима, о. Пхукет, о. Самуи, Паттайя, Пхи-Пхи, Пхитсанулок, Самет, Хуа Хин, Чианг Май, Чианг Рай
Тайвань: Отдых Тайвань 
Танзания: Отдых в Танзании 
Аруша, Занзибар, Килиманджаро, Микуми, Нгоронгоро, о.Мнемба, озеро Маньяра, Селус, Серенгети, Тарангире
Тибет: Отдых в Тибет 
Того: Отдых в Того 
Тринидад и Тобаго: Отдых в Тринидад и Тобаго 
Тунис: Отдых в Тунисе 
Бордж Седрия, Гаммарт, Джерба, Корба, Махдия, Монастир, Набуль, Порт эль Кантауи, Сусс, Тунис, Хаммамет
Туркменистан: Отдых в Туркменистане 
Турция: Отдых в Турции 
Абана, Аклиман, Аланья, Амасра, Анатолия, Анкара, Анталия, Бартин, Белек, Бельдиби, Бергама, Бодрум, Болу, Гайдарос, Герзе, Гиресун, Даврас, Даламан, Датча, Дидим, Зонгулдак, Измир, Инеболу, Искеле, Калкан, Кангал, Каппадокия, Карталкая, Каш, Кемер, Кизилот, Книдос, Конакли, Конья, Курукасиле, Кушадасы, Мармарис, Мерсинчик, Обагол, Паландокен, Памуккале, Ризе, Самсун, Сарыкамыш, Сивас, Сиде, Синоп, Стамбул, Текирова, Тиреболу, Трабзон, Троя, Турклер, Улудаг, Фатса, Фетхие, Хамсилос, Чакраз, Чамьюва, Эрджиес, Эрзурум, Эфес, Якакент
Уганда: Отдых в Уганде 
Узбекистан: Отдых в Узбекистане 
Бухара, Ургенч, Фергана, Хива
Украина: Отдых в Украине 
Алупка, Алушта, Арабатская стрелка, Байдарская долина, Балаклава, Бахчисарай, Белая Церковь, Бердичев, Бердянск, Береговое, Березовая Рудка, Богуслав, Большевик, Борисполь, Борщев, Бровары, Буймеровка, Буковель, Буча, Бучач, Верховина, Вижница, Винница, Воловец, Ворзель, Ворохта, Вышгород, г. Ай-Петри, г. Говерла, Гаспра, Глебовка, Гоголево, Гошев, Гурзуф, Густынь, Диканька, Днепр, Долина, Донецк, Драгобрат, Евпатория, Ждениево, Железный Порт, Житомир, Жолква, Закарпатье, Заозерное, Затока, Золочев, Ивано-Франковск, Иза, Изки-Матачив, Ирпень, Иршава, Калуш, Каменец-Подольский, Карпаты, Кастрополь, Качановка, Керчь, Киев, Кирилловка, Клавдиево, Коблево, Козелец, Коктебель, Коломыя, Кореиз, Корец, Корнич, Коростень, Косов, Кременец, Крехов, Кривориивня, Кропивницкий, Курортное, Курпаты, Куяльник, Ласпи, Ливадия, Луганск, Луцк, Львов, Маков, Малореченск, Малый Маяк, Манява, Мариуполь, Марьяновка, Массандра, Мгар, Меджибож, Межводное, Миргород, Мисхор, Морское, Моршин, Мукачево, мыс Тарханкут, Николаев, Николаевка, Новгород-Северский, Новый Свет, Одесса, Олесько, Орив, Острог, Парковое, Перечин, Переяслав-Хмельницкий, Песочин, Песчаное, Пилипец, Пистынь, Подгорцы, Подобовец, Полтава, Поляна, Полянецкое, Поляница, Понизовка, Почаев, Приветное, Припять, Путивль, Рогатын, Рогозов, с. Оленевка, Святогорск, Севастополь, Симеиз, Симферополь, Синевир, Синевирская Поляна, Синяк, Славское, Славутич, Старые Куты, Стерегущее, Судак, Сумы, Сходница, Татарив, Теребовля, Тернополь, Тисовец, Трускавец, Угловое, Ужгород, Умань, Феодосия, Форос, Харьков, Херсон, Херсонес Таврический, Хмельник, Хмельницкий, Хотин, Чергановка, Черкассы, Чернигов, Чернобыль, Черновцы, Черноморское, Чуфут-Кале, Шацкие озера, Шешоры, Южный Буг, Яблуница, Ялта, Яремче, Ясиня, Ясногородка
Уругвай: Отдых в Уругвае 
Фиджи: Отдых на Фиджи 
Нанди, о. Бенга, о. Вануа - Леву, о. Кадавулайлаи, о. Кандаву, Сува
Филиппины: Отдых на Филиппинах 
Баколод, Боракай, Бохол, Давао, Манила, о. Себу, о.Лусон, о.Малапаскуа, о.Негрос, о.Панай, о.Самар, о.Сикихор, Палаван, Пасай
Финляндия: Отдых в Финляндии 
Вуокатти, Иматра, Инари, Каяани, Куопио, Куусамо Рука, Лапландия, Леви, Люосто, оз.Сайма, Оулу, Пюха, Пюхя, Резиденция Санта-Клауса, Рованиеми, Рука, Саариселка, Тахко, Турку, Хельсинки
Фолклендские (Мальвинские) острова: Отдых на Фолклендских островах 
Франция: Отдых во Франции 
Авиньон, Авориаз, Альп Дюэз, Анже, Анси, Антиб, Ардеш, Аржанта, Аяччо, Бель Плань, Божоле, Больё-сюр-Мер, Бон, Бретань, Валанс, Валь Сени, Валь Торанс, Валь-Д'Изер, Ванс, Вернон, Версаль, Виль Франш, Вогезы, Гренобль, Див-сюр-Мер, Дижон, Довиль, Жуан Ле Пен, Кальви, Канны, Кап Дай, Кап Эстерель, Кодебек-ан-Ко, Куршевель, Ла Плань, Ла Танья, Лазурный Берег, Ле Арк, Ле Дез Альп, Ле Кош, Ле Менюир, Ле-Бо-де-Прованс, Лез Исамбрэ, Лез-Андели, Лилль, Лион, Луар и Шер, Лурд, Люберон, Манделье, Манш, Марсель, Мартиг, Мартиника, Межев, Ментон, Мерибель, Мец, Монпелье, Ницца, Нормандия, о. Корсика, Онфлер, остров Ре, Париж, Перпиньян, Пикардия, Плань Солей, По, Прованс, Пуату-Шаранта, Пьесей - Валандри, Реймс, Руан, Сант Рафаэль, Сен-Бартелеми, Сент Максим, Сибель, Страсбург, Тинс Валь Кларет, Тинь, Три Долины, Флен, Шамбери, Шамони, Шантийи, Эвиан-ле-Бен, Эн, Эперне
Французская Гвиана: Отдых во Французской Гвиане 
Французская Полинезия: Отдых Бора-Бора 
Бора Бора, Муреа, О Тикехау, Папеэте, Раиатеа, Таити, Хуахин
Хорватия: Отдых в Хорватии 
Башка Вода, Биоград, Бол, Брела, Водице, Врсар, Градац, Доньи Михольяц, Дрвеник, Дубровник, Живогоще, Загреб, Задар, Кастел, Кварнер, Корчула, Ловран, Макарска ривьера, Малинска, Медулин, Млини, Нечуям (о. Шолта), Нови Винодольски, Новиград, о. Брач, о. Крк, о. Мльет, о. Чиово, о.Вис, о.Лошинь, о.Паг, о.Раб, Опатия, Петрчане, Пливиц, Плитвицкие озера, Подгора, Подстрана, Пореч, Примостен, Пула, Рабач, Ровинь, Рогозница, Савудрия, Селче, Слано, Слатина, Сплит, Супетар, Трогир, Тучепи, Умаг, Фунтана, Хвар, Цавтат, Цриквеница, Шибеник
Центральноафриканская Республика: Отдых в Центральноафриканской Республике 
Чад: Отдых в Чаде 
Черногория: Отдых в Черногории 
Ада Бояна, Бар, Бечичи, Будва, Герцег Нови, Добра Вода, Доброта, Жабляк, Игало, Колашин, Котор, Кумбор, Луштица, Милочер, Ораховац, Пераст, Петровац, Пржно, Радовичи, Рафаиловичи, Рисан, Свети Стефан, Сутоморе, Тиват, Улцинь, Цетинье
Чехия: Отдых в Чехии 
Берджихов, Брно, Врхлаби (Vrchlabi), Гаррахов (Harrachov), Градчаны, замок Детенице, Златы Горы, Йиндржихув Градец, Карловы Вары, Кутна Гора, Либерец, Марианске Лазне, о. Липно, Оломоуц, Острава, Пец под Снежкой, Пльзень, Подебрады, Прага, Сеч, Теплице, Турнов, Франтишковы Лазне, Чешский Крумлов, Чешский Штернберг, Яхимов
Чили: Отдых в Чили 
Антофагаста, Арика, Вальпараисо, Вина-дель-Мар, Калама, Кальдера, Койайке, Консепсьон, Ранкагуа, Санта Крус, Сантьяго, Торрес-дель-Пайне, Уило-Уило, Футалеуфу
Швейцария: Отдых в Швейцарии 
Ароза, Базель, Берн, Вале, Вербье, Виллар, Гриндельвальд, Гштаад, Давос, Женева, Ивердон, Интерлакен, Кандерштег, Клостерс, Кран-Монтана, Лейкербад, Лозанна, Лугано, Люцерн, Монтре, Нендаз, Понтрезина, Саас-Фе, Санкт-Мориц, Флимс, Церматт, Цюрих
Швеция: Отдых в Швеции 
Будене, Гетеборг, Евлеборг, Карлскруна, Лен Вермланд, Лен Вестерботтен, лен Готланд, лен Норрботтен, Лен Сконе, лен Эребру, Лунд, Стокгольм, Уппсала
Шри-Ланка: Отдых в Шри-Ланке 
Амбалангода, Амбалатнота, Аругам-Бей, Ахунгалла, Бентота, Берувелла, Ваддува, Велигама, Галле, Джафна, Диквелла, Индурува, Калутара, Канди, Киринда, Когалла, Коломбо, Маравила, Матара, Маунт Лавиния, Негомбо, Нувара Элия, Полоннарува, Сигирия, Талпе, Тринкомали, Унаватуна, Хамбантота, Хиккадува, Чилау, Яла
Эквадор: Отдых в Эквадоре 
Кито, Котопакси, Куэнка, острова Галапагос, Отавало, Риобамба
Экваториальная Гвинея: Отдых в Экваториальной Гвинее 
Эритрея: Отдых в Эритрее 
Эстония: Отдых в Эстонии 
Нарва-Йыэсуу, о. Сааремаа, Пярну, Раквере, Таллинн
Эфиопия: Отдых в Эфиопии 
Аддис-Абеба, Арба-Мынч, Бахр-Дар, Гондэр, Джинка, Лалибэла
ЮАР: Отдых в ЮАР 
Ботсвана, Дурбан, Йоханнесбург, Кейптаун, Найзна, Национальный парк Крюгера, Национальный парк Пиланесберг, Оудсхорн, Пиланесберг, Порт-Элизабет, Сан-Сити
Южная Корея: Отдых в Южной Корее 
Пусан, Сеул, Чеджу
Ямайка: Отдых на Ямайке 
Брако, Вестморленд, Голубые горы, Кингстон, Монтего-Бей, Негрил, Очо Риос, Порт Антонио, Порт Ройаль, Раневей-Бей, Трежер-Бич, Фалмут, Черная река
Япония: Отдых в Японии 
Гифу, Йокогама, Камакура, Киото, Нагано, Нагоя, Нара, Никко, Окинава, Осака, Токио, Хаконэ, Хакуба, Хиросима